######################S#######################
#....................#........#.....#.....#..#
#..####..#############..####..#..#..#..#..#..#
#.....#.....#..............#.....#.....#..#..#
####..####..#..##########..##########..#..#..#
#.....#.....#.....#.....#...........#..#..#..#
#######..####..####..#..#######..#..#..#..#..#
#........#.....#.....#...........#..#..#.....#
#..#######..####..#..####..#######..#..#######
#...........#.....#.....#..#.....#..#..#.....#
#############..#######..####..####..#..#..#..#
#...........#..#.....#.....#.....#..#.....#..#
#..#..#..####..#..#..####..####..#..#######..#
#..#..#.....#..#..#.....#........#.....#..#..#
#..#..####..#..#..####..#############..#..#..#
#..#.....#...........#..#...........#..#.....#
#######..##########..####..#######..#..#######
#.....#..#.....#...........#.....#..#..#.....#
#..#..####..#..#..##########..#..#..#..#..#..#
#..#..#.....#..#...........#..#..#..#.....#..#
#..#..#..#######..#######..#..#..##########..#
#..#..#..#.....#.....#.....#..#........#.....#
#..#..#..#..#..####..#..#######..####..#..####
#..#.....#..#..#.....#........#.....#..#.....#
#..#######..#..#############..#..#..#######..#
#........#..#.....#.....#.....#..#..#.....#..#
#..####..#..####..#..#..#..#######..#..#..#..#
#..#.....#..#.....#..#.....#.....#..#..#..#..#
#..#..####..#..####..#######..#..#..#..####..#
#..#.....#..#..#..............#.....#.....#..#
#..#..####..####..#############..####..#..#..#
#..#.....#........#...........#.....#..#.....#
#..####..##########..#######..####..##########
#..#.....#...........#........#..#...........#
#..#..#############..#..#######..#..#######..#
#..#.....#.....#.....#..#.....#.....#.....#..#
#..####..#..#..#..####..#..####..####..#..####
#..#.....#..#..#.....#.....#.....#.....#.....#
#..#######..#..#..#..#######..####..#######..#
#..#........#..#..#..#.....#..#........#.....#
#..#..#..####..#..#..#..#..#..#######..#..####
#.....#.....#..#..#..#..#..#...........#..#..#
#..#######..#..#..#..#..####..##########..#..#
#.....#.....#.....#..#..#.....#........#..#..#
#######..#######..####..#..#..#..####..#..#..#
#........#.....#..#.....#..#..#.....#..#..#..#
#..#######..####..#..####..#..#..#..####..#..#
#........#.....#..#........#..#..#.....#..#..#
#######..#..#..#..#############..#..#..#..#..#
#.....#..#..#..#.....#.....#.....#..#..#.....#
#..#..#..####..#..####..#..#..#..####..#..####
#..#...........#........#.....#..#...........#
###################################E##########
