#########
##..E####
##.####.#
##.####.#
##......#
####.####
####.####
####....#
#######S#
