######################################################################S##
#...#...............#...............#...........#...................#...#
#...#...#########...#...#####...#########...#####...#####...#####...#...#
#...............#.......#...#...........#...........#...#...#.......#...#
#########...#...#########...#########...#####...#...#...#...#########...#
#.......#...#...............#...........#...#...#...#...#...........#...#
#...#...#############...#...#...#########...#####...#...#########...#...#
#...#...............#...#...#.......#...........#...........#.......#...#
#...#############...#####...#####...#...#####...#########...#...#####...#
#...........#.......#...#.......#...#.......#...........#...#...........#
#...#####...#####...#...#####...#...#########...#...#...#...#############
#.......#.......#...#...#.......#.......#.......#...#...#.......#.......#
#############...#...#...#...#########...#...#####...#...#####...#####...#
#...........#...#...........#.......#...#.......#...#.......#...........#
#...#####...#...#########...#####...#...#####...#####...#############...#
#...#.......#...........#...........#.......#...#...#...............#...#
#...#...#########...#...#####...#########...#...#...#############...#...#
#...#...........#...#...#...#...#...........#...............#...#.......#
#...#########...#...#...#...#####...#########...#########...#...#########
#...#.......#...#...#...........#...........#...#.......#...............#
#...#...#####...#####...#####...#########...#####...#...#########...#...#
#...#...................#...........#...............#...............#...#
##E######################################################################
