###################
#S.......#.......E#
#........#........#
#........#........#
#........#........#
#........#........#
###################