1111111111111111111
1200000001000000031
1000000001000000001
1000000001000000001
1000000001000000001
1000000001000000001
1111111111111111111
